111111111111
100000100E01
101010001001
110PC0010001
111111111111