111111111111111111111111111111111111
1PCCCCCCCCCCCCCCCCCCCCCCCCCCCCCCCC01
1C1111111111111111111111111111111101
1ECCCCCCCCCCCCCCCCCCCCCCCCCCCCCCCC01
111111111111111111111111111111111111