11111111111111111111111111111111111111111
10001000000100000000E000000000010Z0000001
10101WC00001000000000000000000010C00000W1
10101111110100000000000000000001W00000001
101000Z000010000000000000000001W000000001
101111000001000000000000000001W0000000001
10001101111100000000000000001W00000000001
10000100000000000000000000000000000000001
10000110000000000000000000000000000000001
10000Y00000000000000P00000000000W00000001
10000000000000000000000000000000000000001
10111111110111000000000000000000000000001
100000W0000111111110000000011111111111111
10001111100100000000000000010001000100001
1Z1110C0100100000000000000010101010101001
100000000011000000000000000001000100010C1
11111111111111111111111111111111111111111