111111111111111111111
1P1C1110100001C00W0Z1
101000000011111100001
101111100000000100001
1000E0000101100100001
10010000010011C100001
10110000WY00001111101
10C100111100111C00101
10010010C100011100101
100000100000000Y00001
111111111111111111111