1111111111111
10011000000W1
1011P00000E01
1C100000Z0001
1Z11111000001
100000000C001
1011X11110001
1000000000001
1111111111111